"a" = (/turf/space,/area)
"b" = (/turf/simulated/wall/r_wall/riveted,/area/awaymission)
"c" = (/obj/machinery/shield,/turf/simulated/wall/cult,/area/awaymission)
"d" = (/obj/machinery/turret{dir = 8; lasers = 1; name = "Angry Turret"},/obj/machinery/light{dir = 1},/turf/simulated/floor/tiled/white,/area/awaymission)
"e" = (/obj/machinery/light{dir = 8},/obj/machinery/turret{dir = 8; lasers = 1; name = "Angry Turret"},/turf/simulated/floor/tiled/white,/area/awaymission)
"f" = (/obj/item/gift,/turf/simulated/floor/tiled/white,/area/awaymission)
"g" = (/turf/simulated/floor/tiled/white,/area/awaymission)
"h" = (/obj/item/gun/energy/gun/nuclear,/turf/simulated/floor/tiled/white,/area/awaymission)
"i" = (/obj/item/soulstone,/turf/simulated/floor/tiled/white,/area/awaymission)
"j" = (/obj/item/ammo_magazine,/turf/simulated/floor/tiled/white,/area/awaymission)
"k" = (/obj/effect/rune,/turf/simulated/floor/tiled/white,/area/awaymission)
"l" = (/obj/machinery/turret{dir = 8; lasers = 1; name = "Angry Turret"},/obj/machinery/light{dir = 4},/turf/simulated/floor/tiled/white,/area/awaymission)
"m" = (/obj/item/assembly/mousetrap/armed,/turf/simulated/floor/tiled/white,/area/awaymission)
"n" = (/obj/item/nullrod,/turf/simulated/floor/tiled/white,/area/awaymission)
"o" = (/obj/item/card/id/captains_spare,/turf/simulated/floor/tiled/white,/area/awaymission)
"p" = (/obj/item/gun/energy/pulse_rifle/M1911,/turf/simulated/floor/tiled/white,/area/awaymission)
"q" = (/obj/item/card/emag,/turf/simulated/floor/tiled/white,/area/awaymission)
"r" = (/obj/item/powersink,/turf/simulated/floor/tiled/white,/area/awaymission)
"s" = (/obj/item/radio/beacon,/obj/item/caution,/turf/simulated/floor/tiled/white,/area/awaymission)
"t" = (/obj/item/brain,/turf/simulated/floor/tiled/white,/area/awaymission)
"u" = (/obj/item/gun/energy/laser/captain,/turf/simulated/floor/tiled/white,/area/awaymission)
"v" = (/obj/item/gun/projectile/deagle/gold,/turf/simulated/floor/tiled/white,/area/awaymission)
"w" = (/obj/item/sord,/turf/simulated/floor/tiled/white,/area/awaymission)
"x" = (/obj/item/gun/energy/lasercannon,/turf/simulated/floor/tiled/white,/area/awaymission)
"y" = (/obj/item/gun/energy/crossbow/largecrossbow,/turf/simulated/floor/tiled/white,/area/awaymission)
"z" = (/obj/item/gun/energy/pulse_rifle/destroyer,/turf/simulated/floor/tiled/white,/area/awaymission)
"A" = (/obj/item/toy/spinningtoy,/turf/simulated/floor/tiled/white,/area/awaymission)
"B" = (/obj/item/card/id/centcom,/turf/simulated/floor/tiled/white,/area/awaymission)
"C" = (/obj/item/gun/grenadelauncher,/turf/simulated/floor/tiled/white,/area/awaymission)
"D" = (/obj/machinery/turret{dir = 8; lasers = 1; name = "Angry Turret"},/obj/machinery/light,/turf/simulated/floor/tiled/white,/area/awaymission)

(1,1,1) = {"
aaaaaaaaaaaaaaaaaaaaaaaaaaaaaa
aaaaaaaaaaaaaaaaaaaaaaaaaaaaaa
aaaaaaaaaaaaaaaaaaaaaaaaaaaaaa
aaaaaaaaaaaaaaaaaaaaaaaaaaaaaa
aaaaaaaaaaaaaaaaaaaaaaaaaaaaaa
aaaaaaaaaaaaaaaaaaaaaaaaaaaaaa
aaaaaaaaaaaaaaaaaaaaaaaaaaaaaa
aaaaaaaaaaaaaaaaaaaaaaaaaaaaaa
aaaaaaaaaaaaaaaaaaaaaaaaaaaaaa
aaaaaaaaabbbbbbbbbbbbaaaaaaaaa
aaaaaaaaabccccccccccbaaaaaaaaa
aaaaaaaaabccddddddccbaaaaaaaaa
aaaaaaaaabcefghijklcbaaaaaaaaa
aaaaaaaaabcemnopgqlcbaaaaaaaaa
aaaaaaaaabcegrgstglcbaaaaaaaaa
aaaaaaaaabceuggvgwlcbaaaaaaaaa
aaaaaaaaabcegxygzglcbaaaaaaaaa
aaaaaaaaabceAgBgCglcbaaaaaaaaa
aaaaaaaaabccDDDDDDccbaaaaaaaaa
aaaaaaaaabccccccccccbaaaaaaaaa
aaaaaaaaabbbbbbbbbbbbaaaaaaaaa
aaaaaaaaaaaaaaaaaaaaaaaaaaaaaa
aaaaaaaaaaaaaaaaaaaaaaaaaaaaaa
aaaaaaaaaaaaaaaaaaaaaaaaaaaaaa
aaaaaaaaaaaaaaaaaaaaaaaaaaaaaa
aaaaaaaaaaaaaaaaaaaaaaaaaaaaaa
aaaaaaaaaaaaaaaaaaaaaaaaaaaaaa
aaaaaaaaaaaaaaaaaaaaaaaaaaaaaa
aaaaaaaaaaaaaaaaaaaaaaaaaaaaaa
aaaaaaaaaaaaaaaaaaaaaaaaaaaaaa
"}
