"a" = (/turf/space,/area/space)
"b" = (/turf/closed/rock,/area/external/asteroid/mine/unexplored)
"c" = (/turf/closed/wall/reinforced,/area/away_mission/listeningpost)
"d" = (/turf/open/floor/plating/metal,/area/away_mission/listeningpost)
"e" = (/obj/machinery/power/smes/magical{desc = "A high-capacity superconducting magnetic energy storage (SMES) unit."; name = "power storage unit"},/turf/open/floor/plating/metal,/area/away_mission/listeningpost)
"f" = (/obj/machinery/door/airlock,/turf/open/floor,/area/away_mission/listeningpost)
"g" = (/turf/closed/wall/steel,/area/away_mission/listeningpost)
"h" = (/obj/structure/table,/obj/item/paper/monitorkey,/obj/item/radio/intercom{desc = "Talk through this. Evilly"; freerange = 1; frequency = 1213; name = "Syndicate Intercom"; pixel_x = 32; subspace_transmission = 1; syndie = 1},/obj/item/clothing/glasses/regular,/turf/open/floor,/area/away_mission/listeningpost)
"i" = (/obj/structure/table,/turf/open/floor,/area/away_mission/listeningpost)
"j" = (/turf/open/floor,/area/away_mission/listeningpost)
"k" = (/obj/machinery/door/airlock/external,/turf/open/floor/plating/metal,/area/away_mission/listeningpost)
"l" = (/turf/open/floor/plating/asteroid/airless,/area/external/asteroid/mine/explored)
"m" = (/obj/machinery/computer/message_monitor,/turf/open/floor,/area/away_mission/listeningpost)
"n" = (/obj/structure/stool/bed/chair{dir = 4},/mob/living/simple_animal/hostile/syndicate{desc = "A weary looking syndicate operative."},/turf/open/floor,/area/away_mission/listeningpost)
"o" = (/obj/structure/table,/obj/item/paper{info = "Nothing of interest to report."; name = "november report"},/obj/item/pen,/turf/open/floor,/area/away_mission/listeningpost)
"p" = (/obj/item/radio/intercom{desc = "Talk through this. Evilly"; freerange = 1; frequency = 1213; name = "Syndicate Intercom"; pixel_x = 32; subspace_transmission = 1; syndie = 1},/turf/open/floor,/area/away_mission/listeningpost)
"q" = (/obj/structure/rack,/obj/item/clothing/suit/space/syndicate,/obj/item/clothing/mask/gas,/obj/item/clothing/head/helmet/space/syndicate,/turf/open/floor,/area/away_mission/listeningpost)
"r" = (/obj/machinery/door/airlock,/obj/item/paper{info = "I wonder how much longer they will accept my empty reports. They will cancel the case  soon without results.  When the pickup comes, I will tell them I have lost faith in our cause, and beg them to consider a diplomatic solution. How many nuclear teams have been dispatched with those nukes? I must try and prevent more from ever being sent. If they will not listen to reason, I will detonate the warehouse myself. Maybe some day in the immediate future, space will be peaceful, though I don't intend to live to see it. And that is why I write this down- it is my sacrifice that stabilised your worlds, traveller. Spare a thought for me, and please attempt to prevent nuclear proliferation, should it ever rear it's ugly head again. -Donk Co. Operative #451"; name = "odd report"},/obj/item/gun/projectile/pistol,/obj/item/silencer,/turf/open/floor,/area/away_mission/listeningpost)
"s" = (/obj/structure/disposalpipe/segment{dir = 4; icon_state = "pipe-c"},/turf/closed/rock,/area/external/asteroid/mine/unexplored)
"t" = (/obj/structure/disposalpipe/segment{dir = 4},/turf/closed/rock,/area/external/asteroid/mine/unexplored)
"u" = (/obj/structure/disposaloutlet{dir = 4},/obj/structure/disposalpipe/trunk{dir = 8},/turf/open/floor/plating/metal/airless,/area/space)
"v" = (/obj/structure/stool/bed,/obj/item/bedsheet/brown,/turf/open/floor,/area/away_mission/listeningpost)
"w" = (/obj/structure/table,/obj/item/flashlight/lamp,/turf/open/floor,/area/away_mission/listeningpost)
"x" = (/obj/machinery/vending/snack,/turf/open/floor,/area/away_mission/listeningpost)
"y" = (/obj/structure/disposalpipe/segment,/turf/closed/rock,/area/external/asteroid/mine/unexplored)
"z" = (/obj/machinery/vending/cola,/turf/open/floor,/area/away_mission/listeningpost)
"A" = (/obj/structure/closet,/obj/item/clothing/gloves/boxing,/turf/open/floor,/area/away_mission/listeningpost)
"B" = (/obj/structure/filingcabinet,/obj/item/paper{info = "A good start to the operation: intercepted Nanotrasen military communications. A convoy is scheduled to transfer nuclear warheads to a new military base. This is as good a chance as any to get our hands on some heavy weaponry, I suggest we take it."; name = "april report"},/obj/item/paper{info = "Nothing of real interest to report this month. I have intercepted faint transmissions from what appears to be some sort of pirate radio station. They do not appear to be relevant to my assignment."; name = "may report"},/obj/item/paper{info = "Nanotrasen communications have been noticably less frequent recently.  The pirate radio station I found last month has been transmitting pro-Nanotrasen propaganda. I will continue to monitor it."; name = "june report"},/obj/item/paper{info = "Nothing of interest to report."; name = "july report"},/obj/item/paper{info = "Nothing of interest to report."; name = "august report"},/obj/item/paper{info = "Nothing of interest to report."; name = "september report"},/obj/item/paper{info = "Nothing of interest to report."; name = "october report"},/obj/item/paper{info = "1 x Stechtkin pistol - $600<br>1 x silencer - $200<br>shipping charge - $4360<br>total - $5160"; name = "receipt"},/turf/open/floor,/area/away_mission/listeningpost)
"C" = (/obj/structure/table,/obj/item/paper{info = "<b>Mission Details</b>: You have been assigned to a newly constructed listening post constructed within an asteroid in Nanotrasen space to monitor their plasma mining operations. Accurate intel is crucial to the success of our operatives onboard, do not fail us."; name = "mission briefing"},/turf/open/floor,/area/away_mission/listeningpost)
"D" = (/obj/machinery/disposal,/obj/structure/disposalpipe/trunk{dir = 4},/turf/open/floor,/area/away_mission/listeningpost)
"E" = (/obj/structure/disposalpipe/segment{dir = 4},/turf/closed/wall/reinforced,/area/away_mission/listeningpost)
"F" = (/obj/structure/disposalpipe/segment{dir = 8; icon_state = "pipe-c"},/turf/closed/rock,/area/external/asteroid/mine/unexplored)
"G" = (/obj/machinery/door/airlock{name = "Toilet"},/turf/open/floor,/area/away_mission/listeningpost)
"H" = (/turf/open/floor/tiled/freezer,/area/away_mission/listeningpost)
"I" = (/obj/machinery/shower{dir = 8; tag = "icon-shower (WEST)"},/turf/open/floor/tiled/freezer,/area/away_mission/listeningpost)
"J" = (/obj/structure/toilet{dir = 8; tag = "icon-toilet00 (WEST)"},/turf/open/floor/tiled/freezer,/area/away_mission/listeningpost)
"K" = (/turf/closed/rock/bananium,/area/external/asteroid/mine/unexplored)
"L" = (/turf/closed/wall/shuttle{icon_state = "wall3"; tag = "icon-wall3"},/area/external/asteroid/mine/explored)
"M" = (/turf/open/floor/circuit_grid/green/airless{tag = "icon-gcircuit"},/area/external/asteroid/mine/explored)
"N" = (/obj/machinery/gateway{dir = 9; tag = "icon-off (NORTHWEST)"},/turf/open/floor/circuit_grid/green/airless{tag = "icon-gcircuit"},/area/external/asteroid/mine/explored)
"O" = (/obj/machinery/gateway{dir = 1; tag = "icon-off (NORTH)"},/turf/open/floor/circuit_grid/green/airless{tag = "icon-gcircuit"},/area/external/asteroid/mine/explored)
"P" = (/obj/machinery/gateway{dir = 5; tag = "icon-off (NORTHEAST)"},/turf/open/floor/circuit_grid/green/airless{tag = "icon-gcircuit"},/area/external/asteroid/mine/explored)
"Q" = (/obj/machinery/gateway{dir = 8; tag = "icon-off (WEST)"},/turf/open/floor/circuit_grid/green/airless{tag = "icon-gcircuit"},/area/external/asteroid/mine/explored)
"R" = (/obj/machinery/gateway/centeraway,/turf/open/floor/circuit_grid/green/airless{tag = "icon-gcircuit"},/area/external/asteroid/mine/explored)
"S" = (/obj/machinery/gateway{dir = 4; tag = "icon-off (EAST)"},/turf/open/floor/circuit_grid/green/airless{tag = "icon-gcircuit"},/area/external/asteroid/mine/explored)
"T" = (/obj/machinery/gateway{dir = 10; tag = "icon-off (SOUTHWEST)"},/turf/open/floor/circuit_grid/green/airless{tag = "icon-gcircuit"},/area/external/asteroid/mine/explored)
"U" = (/obj/machinery/gateway,/turf/open/floor/circuit_grid/green/airless{tag = "icon-gcircuit"},/area/external/asteroid/mine/explored)
"V" = (/obj/machinery/gateway{dir = 6; tag = "icon-off (SOUTHEAST)"},/turf/open/floor/circuit_grid/green/airless{tag = "icon-gcircuit"},/area/external/asteroid/mine/explored)

(1,1,1) = {"
aaaaaaaaaaaaaaaaaaaaaaaaaaaaaaaaaaaaaaaaaaaaaaaaaaaaaaaaaaaaaaaaaaaaaaaaaaaaaaaaaaaaaaaaaaaaaaaaaaaa
aaaaaaaaaaaaaaaaaaaaaaaaaaaaaaaaaaaaaaaaaaaaaaaaaaaaaaaaaaaaaaaaaaaaaaaaaaaaaaaaaaaaaaaaaaaaaaaaaaaa
aaaaaaaaaaaaaaaaaaaaaaaaaaaaaaaaaaaaaaaaaaaaaaaaaaaaaaaaaaaaaaaaaaaaaaaaaaaaaaaaaaaaaaaaaaaaaaaaaaaa
aaaaaaaaaaaaaaaaaaaaaaaaaaaaaaaaaaaaaaaaaaaaaaaaaaaaaaaaaaaaabbbaaaaaaaaaaaaaaaaaaaaaaaaaaaaaaaaaaaa
aaaaaaaaaaaaaaaaaaaaaaaaaaaaaaaaaaaaaaaaaaaaaaaaaaaaaaaaaaabbbbbbaaaaaaaaaaaaabbbbbbbbbbaaaaaaaaaaaa
aaaaaaaaaaaaaaaaaaaaaaaaaaaaaaaaaaaaaaaaaaaaaaaaaaaaaaaaaaabbbbbbbbbaaaaaabbbbbbbbbbbbbbbbaaaaaaaaaa
aaaaaaaaaaaaaaaaaaaaaaaaaaaaaaaaaaaaaaaaaaaaaaaaaaaaaaaaaaabbbbbbbbbbbbbbbbbbbbbbbbbbbbbbbaaaaaaaaaa
aaaaaaaaaaaaaaaaaaaaaaaaaaaaaaaaaaaaaaaaaaaaaaaaaaaaaaaaaaaabbbbbbbbbbbbbbbbbbbbbbbbbbbbbbbaaaaaaaaa
aaaaaaaaaaaaaaaaaaaaaaaaaaaaaaaaaaaaaaaaaaaaaaaaaaaaaaaaaaaaaabbbbbbbbbbbbbbbbbbbbbbbbbbbbbaaaaaaaaa
aaaaaaaaaaaaaaaaaaaaaaaaaaaaaaaaaaaaaaaaaaaaaaaaaaaaaaaaaaaaaabbbbbbbbbbbbbbbbbbbbbbbbbbbbbbaaaaaaaa
aaaaaaaaaaaaaaaaaaaaaaaaaaaaaaaaaaaaaaaaaaaaaaaaaaaaaaaaaaaaabbbbbbbbbbbbbbbbbbbbbbbbbbbbbbbbaaaaaaa
aaaaaaaaaaaaaaaaaaaaaaaaaaaaaaaaaaaaaaaaaaaaaaaaaaaaaaaaaaaaabbbbbbbbbbbbbbbbbbbbbbbccccbbbbbaaaaaaa
aaaaaaaaaaaaaaaaaaaaaaaaaaaaaaaaaaaaaaaaaaaaaaaaaaaaaaaaaaaaabbbbbbbbbbbbbbbbbbbbbbbcdecbbbbbaaaaaaa
aaaaaaaaaaaaaaaaaaaaaaaaaaaaaaaaaaaaaaaaaaaaaaaaaaaaaaaaaaaaabbbbbbbbbbbbbbbbbbbbbcccfgccccaaaaaaaaa
aaaaaaaaaaaaaaaaaaaaaaaaaaaaaaaaaaaaaaaaaaaaaaaaaaaaaaaaaaaaaabbbbbbbbbbbbbbbbbbbcchijjkddkaaaaaaaaa
aaaaaaaaaaaaaaaaaaaaaaaaaaaaaaaaaaaaaaaaaaaaaaaaaaaaaaaaaaaaaalbbbbbbbbbbbbbbbbbbcmnojjkddkaaaaaaaaa
aaaaaaaaaaaaaaaaaaaaaaaaaaaaaaaaaaaaaaaaaaaaaaaaaaaaaaabbbbbbalbbbbbbbbbbbbbbbbbbccpijjccccaaaaaaaaa
aaaaaaaaaaaaaaaaaaaaaaaaaaaaaaaaaaaaaaaaaaaaaaaaaaaaabbbbbbbbllbbbbbbbbbbbbbbbbbbbcjjjqcbbbbaaaaaaaa
aaaaaaaaaaaaaaaaaaaaaaaaaaaaaaaaaaaaaaaaaaaaaaaaaabbbbbbbbbbbblbbbbbbbbbbbbbbbbccccrgggcbsttuaaaaaaa
aaaaaaaaaaaaaaaaaaaaaaaaaaaaaaaaaaaaaaaaaaaaaaaaabbbbbbbbbbbbbbbbbbbbbbbbbbbbbbcvwgjjjxcbybbbbbbaaaa
aaaaaaaaaaaaaaaaaaaaaaaaaaaaaaaaaaaaaaaaaaaaaaaaabbbbbbbbbbbbbbbbbbbbbbbbbbbbbbcjjfjjjzcbybbbbbbbaaa
aaaaaaaaaaaaaaaaaaaaaaaaaaaaaaaaaaaaaaaaaaaaaaaaabbbbbbbbbbbbbbbbbbbbbbbbbbbbbbcABgCjDEEtFbbbbbaaaaa
aaaaaaaaaaaaaaaaaaaaaaaaaaaaaaaaaaaaaaaaaaaaaaaabbbbbbbbbbbbbbbbbbbbbbbbbbbbbbbcccccGgcbbbbbbbbbaaaa
aaaaaaaaaaaaaaaaaaaaaaaaaaaaaaaaaaaaaaaaaaaaaaaabbbbbbbbbbbbbbbbbbbbbbbbbbbbbbbbbbbcHIcbbbbbbbbbaaaa
aaaaaaaaaaaaaaaaaaaaaaaaaaaaaaaaaaaaaaaaaaaaaaaabbbbbbbbbbbbbbbbbbbbbbbbbbbbbbbbbbbcHJcbbbbbbbbbbaaa
aaaaaaaaaaaaaaaaaaaaaaaaaaaaaaaaaaaaaaaaaaaaaaaaabbbbbbbbbbbbbbbbbbbbbbbbbbbbbbbbbbccccbbbbbbbbbbbaa
aaaaaaaaaaaaaaaaaaaaaaaaaaaaaaaaaaaaaaaaaaaaaaaaabbbbbbbbbbbbbbbbbbbbbbbbbbbbbbbbbbbbbbbbbbbbbbbbbaa
aaaaaaaaaaaaaaaaaaaaaaaaaaaaaaaaaaaaaaaaaaaaaaaaabbbbbbbbbbbbbbbbbbbbbbbbbbbbbbbbbbbbbbbbbbbbbbbbbaa
aaaaaaaaaaaaaaaaaaaaaaaaaaaaaaaaaaaaaaaaaaaaaaabbbbbbbbbbbbbbbbbbbbbbbbbbbbbbbbbbbbbbbbbbbbbbbbbbbaa
aaaaaaaaaaaaaaaaaaaaaaaaaaaaaaaaaaaaaaaaaaaabbbbbbbbbbbbbbbbbbbbbbbbbbbbbbbbbbbbbbbbbbbbbbbbbbbbbaaa
aaaaaaaaaaaaaaaaaaaaaaaaaaaaaaaaaaaaaaaaaabbbbbbbbbbbbbbbbbbbbbbbbbbbbbbbbbbbbbbbbbbbbbbbbbbbbbbbaaa
aaaaaaaaaaaaaaaaaaaaaaaaaaaaaaaaaaaaaaaaaabbbbbbbbbbbbbbbbbbbbbbbbbbbbbbbbbbbbbbbbbbbbbbbbbbbbbbaaaa
aaaaaaaaaaaaaaaaaaaaaaaaaaaaaaaaaaaaaaaaaabbbbbbbbbbbbbbbbbbbbbbbbbbbbbbbbbbbbbbbbbbbbbbbbbbbbbbaaaa
aaaaaaaaaaaaaaaaaaaaaaaaaaaaaaaaaaaaaaaaaaabbbbbbbbbbbbbbbbbbbbbbbbbblllbbbbbbbbbbbbbbbbbbbbaaaaaaaa
aaaaaaaaaaaaaaaaaaaaaaaaaaaaaaaaaaaaaaaaaaabbbbbbbbbbbbbbbbKKbbbbbbbllaaabbbbbbbbbbbbbbbbbaaaaaaaaaa
aaaaaaaaaaaaaaaaaaaaaaaaaaaaaaaaaaaaaaaaaaabbbbbbbbbbbbbbbbbKbbKbbblllaaaabbbbbbbbbbbbbbaaaaaaaaaaaa
aaaaaaaaaaaaaaaaaaaaaaaaaaaaaaaaaaaaaaaaaaaabbbbbbbbbbbKbbbbbbbbbbbblaaaaabbbbbbbbbbbbbbaaaaaaaaaaaa
aaaaaaaaaaaaaaaaaaaaaaaaaaaaaaaaaaaaaaaaaaaaabbbbbbbbbbKKbbbbbbbbbbblaaaabbbbbbbbbbbbbaaaaaaaaaaaaaa
aaaaaaaaaaaaaaaaaaaaaaaaaaaaaaaaaaaaaaaaaaaaabbbbbbbbbbKKbbbbbbbbbbblaabbbbbbbbbbbbbbaaaaaaaaaaaaaaa
aaaaaaaaaaaaaaaaaaaaaaaaaaaaaaaaaaaaaaaaaaaaabbbbbbbbbbbbbbbbbKbbbbbbaabbbbbbbbbbbbbaaaaaaaaaaaaaaaa
aaaaaaaaaaaaaaaaaaaaaaaaaaaaaaaaaaaaaaaaaaabbbbbbbbbbbbbbbbbbbbbbbbbbabbbbbbbbbbbbaaaaaaaaaaaaaaaaaa
aaaaaaaaaaaaaaaaaaaaaaaaaaabbbbaaaaaaaaaabbbbbbbbbbbbbbbbbbbbbbbbbbbbbbbbbbbbbbbbaaaaaaaaaaaaaaaaaaa
aaaaaaaaaaaaaaaaaaaaaaaaaabbbbbbbaaaaaabbbbbbbbbbbbbbbbbbbbKKbbbbbbbbbbbbbbbbbbbbaaaaaaaaaaaaaaaaaaa
aaaaaaaaaaaaaaaaaaaaaaaaabbbbbbbbbbbaaabbbbbbbbbbbbbbbbKbbbbbbbbbbbbbbbbbbbbbbbbaaaaaaaaaaaaaaaaaaaa
aaaaaaaaaaaaaaaaaaaaaaaabbbbbbbbbbbbbbbbbbbbbbbbbbbbbbbbbbbbbbbbKbbbbbbbbbbbbbbaaaaaaaaaaaaaaaaaaaaa
aaaaaaaaaaaaaaaaaaaaaaaabbbbbbbbbbbbbbbbbbbbbbbbbbbbbbbbbbbbbbbbbbbbbbbbbbbbbbbaaaaaaaaaaaaaaaaaaaaa
aaaaaaaaaaaaaaaaaaaaaaaabbbbbbbbbbbbbbbbbbbbbbbbbbbbbbbbbbbbbbbKKbbbbbbbbbbbbbbbaaaaaaaaaaaaaaaaaaaa
aaaaaaaaaaaaaaaaaaaaaaabbbbbbbbbbbbbbbbbbbbbbbbbbbbbbbbbbbbbbbbbbbbbbbblllllbbbbaaaaaaaaaaaaaaaaaaaa
aaaaaaaaaaaaaaaaaaaaaaabbbbbbbbbbbbbbbbbbbbbbbbbbbbbbbbbbbbbbbbbbbbbbbbblaaaabbaaaaaaaaaaaaaaaaaaaaa
aaaaaaaaaaaaaaaaaaaaaaabbbbbbbbbbbbbbbbbbbbbbbbbbbbbbbbbbbbbbbbbbbbbbbbbbllbaaaaaaaaaaaaaaaaaaaaaaaa
aaaaaaaaaaaaaaaaaaaaaaabbbbbbbbbbbbbbbbbbbbbbbbbbbbbbbbbbbbbbbbbbbbbbbbbbbbbbaaaaaaaaaaaaaaaaaaaaaaa
aaaaaaaaaaaaaaaaaaaaaabbbbbbbbbbbbbbbbbbbbbbbbbbbbbLLLLLLLbbbbbbbbbbbbbbbbbbbaaaaaaaaaaaaaaaaaaaaaaa
aaaaaaaaaaaaaaaaaaaaaabbbbbbbbbbbbbbbbbbbbbbbbbbbbblMMMMMLbbbbbbbbbbbbbbbbbbbaaaaaaaaaaaaaaaaaaaaaaa
aaaaaaaaaaaaaaaaaaaaaabbbbbbbbbbbbbbbbbbbbbbbbbbbbbbMNOPMLbbbbbbbbbbbbbbbbbbbaaaaaaaaaaaaaaaaaaaaaaa
aaaaaaaaaaaaaaaaaaaaabbbbbbbbbbbbbbbbbbbbbbbbbbbbbbbbQRSMLbbbbbbbbbbbbbbbbbbbbaaaaaaaaaaaaaaaaaaaaaa
aaaaaaaaaaaaaaaaaaaaabbbbbbbbbbbbbbbblbbbbbbbbbbbbbbMTUVMLbbbbbbbbbbbbbbbbbbbbaaaaaaaaaaaaaaaaaaaaaa
aaaaaaaaaaaaaaaaaaaaabbbbbbbbbbbbbbbbllbbbbbbbbbbbbblMMMMLbbbbbbbbbbbbbbbbbbbbaaaaaaaaaaaaaaaaaaaaaa
aaaaaaaaaaaaaaaaaaaaabbbbbbbbbbbbbbbaalbbbbbbbbbbbbllLLLLLbbbbbbbbbbbbbbbbbbbbaaaaaaaaaaaaaaaaaaaaaa
aaaaaaaaaaaaaaaaaaaaabbbbbbbbbbbbbaaaabbbbbbbbbbbbbbbbbbbbbbbbbbbbbbbbbbbbbbbbaaaaaaaaaaaaaaaaaaaaaa
aaaaaaaaaaaaaaaaaaaaaabbbbbbbbbbbaaaaabbbbbbbbbbbbbbbbbbbbbbbbbbbbbbbbbbbbbbbbaaaaaaaaaaaaaaaaaaaaaa
aaaaaaaaaaaaaaaaaaaaaaaaaabbbbbbaaaaaabbbbbbbbbbbbbbbbbbbbbbbbbbbbbbbbbbbbbbbbaaaaaaaaaaaaaaaaaaaaaa
aaaaaaaaaaaaaaaaaaaaaaaaaaaaaaaaaaaaaabbbbbbbbbblbbbbbbbbbbbbbbbbbbbbbbbbbbbbbaaaaaaaaaaaaaaaaaaaaaa
aaaaaaaaaaaaaaaaaaaaaaaaaaaaaaaaaaaaaaabbbbbbbbllbbbbbbbbbbbbbbbbbbbbbbbbbbbaaaaaaaaaaaaaaaaaaaaaaaa
aaaaaaaaaaaaaaaaaaaaaaaaaaaaaaaaaaaaaaabbbbbbbbalbbbbbbbbbbbbbbbbbbbbbbbbbbbaaaaaaaaaaaaaaaaaaaaaaaa
aaaaaaaaaaaaaaaaaaaaaaaaaaaaaaaaaaaaaaabbbbbbbaalbbbbbbbbbbbbbbbbbbbbbbbbbbaaaaaaaaaaaaaaaaaaaaaaaaa
aaaaaaaaaaaaaaaaaaaaaaaaaaaaaaaaaaaaaaaaabbbbaaabbbbbbbbbbbbbbbbbbbbbbbbbbaaaaaaaaaaaaaaaaaaaaaaaaaa
aaaaaaaaaaaaaaaaaaaaaaaaaaaaaaaaaaaaaaaaaaaaaaaabbbbbbbbbbbbbbbbbbbbbbbbbbaaaaaaaaaaaaaaaaaaaaaaaaaa
aaaaaaaaaaaaaaaaaaaaaaaaaaaaaaaaaaaaaaaaaaaaaaabbbbbbbbbbbbbbbbbbbbbbbbbbbaaaaaaaaaaaaaaaaaaaaaaaaaa
aaaaaaaaaaaaaaaaaaaaaaaaaaaaaaaaaaaaaaaaaaaaaaabbbbbbbbbbbbbbbbbbbbbbbbbaaaaaaaaaaaaaaaaaaaaaaaaaaaa
aaaaaaaaaaaaaaaaaaaaaaaaaaaaaaaaaaaaaaaaaaaaabbbbbbbbbbbbbbbbbbbbbbbbbbbaaaaaaaaaaaaaaaaaaaaaaaaaaaa
aaaaaaaaaaaaaaaaaaaaaaaaaaaaaaaaaaaaaaaaaaabbbbbbbbbbbbbbbbbbbbbbbbbbbbbaaaaaaaaaaaaaaaaaaaaaaaaaaaa
aaaaaaaaaaaaaaaaaaaaaaaaaaaaaaaaaaaaaaaaaaabbbbbbbbbbbbbbbbbbbbbbbbbbbbbaaaaaaaaaaaaaaaaaaaaaaaaaaaa
aaaaaaaaaaaaaaaaaaaaaaaaaaaaaaaaaaaaaaaaaabbbbbbbbbbbbbbbbbbbbbbbbbbbbbbaaaaaaaaaaaaaaaaaaaaaaaaaaaa
aaaaaaaaaaaaaaaaaaaaaaaaaaaaaaaaaaaaaaaaaabbbbbbbbbbbbbbbbbbbbbbbbbbbbbaaaaaaaaaaaaaaaaaaaaaaaaaaaaa
aaaaaaaaaaaaaaaaaaaaaaaaaaaaaaaaaaaaaaaaaabbbbbbbbbbbbbbbbbbbbbbbbbbbbbaaaaaaaaaaaaaaaaaaaaaaaaaaaaa
aaaaaaaaaaaaaaaaaaaaaaaaaaaaaaaaaaaaaaaaaaaabbbbbbbbbbbbbbbbbbbbbbbbbbaaaaaaaaaaaaaaaaaaaaaaaaaaaaaa
aaaaaaaaaaaaaaaaaaaaaaaaaaaaaaaaaaaaaaaaaaaabbbbbbbbbbbbbbbbbbbbbbbbbbaaaaaaaaaaaaaaaaaaaaaaaaaaaaaa
aaaaaaaaaaaaaaaaaaaaaaaaaaaaaaaaaaaaaaaaaaaaaabbbbbbbbbbbbbbbbbbbbbbbbaaaaaaaaaaaaaaaaaaaaaaaaaaaaaa
aaaaaaaaaaaaaaaaaaaaaaaaaaaaaaaaaaaaaaaaaaaaaaaaaabbbbbbbbbbbbbbbbbbbaaaaaaaaaaaaaaaaaaaaaaaaaaaaaaa
aaaaaaaaaaaaaaaaaaaaaaaaaaaaaaaaaaaaaaaaaaaaaaaaaaabbbbbbbbbbbbbbbbbbaaaaaaaaaaaaaaaaaaaaaaaaaaaaaaa
aaaaaaaaaaaaaaaaaaaaaaaaaaaaaaaaaaaaaaaaaaaaaaaaaaaaaaabbbbbbbbbbbbbbaaaaaaaaaaaaaaaaaaaaaaaaaaaaaaa
aaaaaaaaaaaaaaaaaaaaaaaaaaaaaaaaaaaaaaaaaaaaaaaaaaaaaaaaabbbbbbbbaaaaaaaaaaaaaaaaaaaaaaaaaaaaaaaaaaa
aaaaaaaaaaaaaaaaaaaaaaaaaaaaaaaaaaaaaaaaaaaaaaaaaaaaaaaaabbbbbbbaaaaaaaaaaaaaaaaaaaaaaaaaaaaaaaaaaaa
aaaaaaaaaaaaaaaaaaaaaaaaaaaaaaaaaaaaaaaaaaaaaaaaaaaaaaaaaaaaaaaaaaaaaaaaaaaaaaaaaaaaaaaaaaaaaaaaaaaa
aaaaaaaaaaaaaaaaaaaaaaaaaaaaaaaaaaaaaaaaaaaaaaaaaaaaaaaaaaaaaaaaaaaaaaaaaaaaaaaaaaaaaaaaaaaaaaaaaaaa
aaaaaaaaaaaaaaaaaaaaaaaaaaaaaaaaaaaaaaaaaaaaaaaaaaaaaaaaaaaaaaaaaaaaaaaaaaaaaaaaaaaaaaaaaaaaaaaaaaaa
aaaaaaaaaaaaaaaaaaaaaaaaaaaaaaaaaaaaaaaaaaaaaaaaaaaaaaaaaaaaaaaaaaaaaaaaaaaaaaaaaaaaaaaaaaaaaaaaaaaa
aaaaaaaaaaaaaaaaaaaaaaaaaaaaaaaaaaaaaaaaaaaaaaaaaaaaaaaaaaaaaaaaaaaaaaaaaaaaaaaaaaaaaaaaaaaaaaaaaaaa
aaaaaaaaaaaaaaaaaaaaaaaaaaaaaaaaaaaaaaaaaaaaaaaaaaaaaaaaaaaaaaaaaaaaaaaaaaaaaaaaaaaaaaaaaaaaaaaaaaaa
aaaaaaaaaaaaaaaaaaaaaaaaaaaaaaaaaaaaaaaaaaaaaaaaaaaaaaaaaaaaaaaaaaaaaaaaaaaaaaaaaaaaaaaaaaaaaaaaaaaa
aaaaaaaaaaaaaaaaaaaaaaaaaaaaaaaaaaaaaaaaaaaaaaaaaaaaaaaaaaaaaaaaaaaaaaaaaaaaaaaaaaaaaaaaaaaaaaaaaaaa
aaaaaaaaaaaaaaaaaaaaaaaaaaaaaaaaaaaaaaaaaaaaaaaaaaaaaaaaaaaaaaaaaaaaaaaaaaaaaaaaaaaaaaaaaaaaaaaaaaaa
aaaaaaaaaaaaaaaaaaaaaaaaaaaaaaaaaaaaaaaaaaaaaaaaaaaaaaaaaaaaaaaaaaaaaaaaaaaaaaaaaaaaaaaaaaaaaaaaaaaa
aaaaaaaaaaaaaaaaaaaaaaaaaaaaaaaaaaaaaaaaaaaaaaaaaaaaaaaaaaaaaaaaaaaaaaaaaaaaaaaaaaaaaaaaaaaaaaaaaaaa
aaaaaaaaaaaaaaaaaaaaaaaaaaaaaaaaaaaaaaaaaaaaaaaaaaaaaaaaaaaaaaaaaaaaaaaaaaaaaaaaaaaaaaaaaaaaaaaaaaaa
aaaaaaaaaaaaaaaaaaaaaaaaaaaaaaaaaaaaaaaaaaaaaaaaaaaaaaaaaaaaaaaaaaaaaaaaaaaaaaaaaaaaaaaaaaaaaaaaaaaa
aaaaaaaaaaaaaaaaaaaaaaaaaaaaaaaaaaaaaaaaaaaaaaaaaaaaaaaaaaaaaaaaaaaaaaaaaaaaaaaaaaaaaaaaaaaaaaaaaaaa
aaaaaaaaaaaaaaaaaaaaaaaaaaaaaaaaaaaaaaaaaaaaaaaaaaaaaaaaaaaaaaaaaaaaaaaaaaaaaaaaaaaaaaaaaaaaaaaaaaaa
aaaaaaaaaaaaaaaaaaaaaaaaaaaaaaaaaaaaaaaaaaaaaaaaaaaaaaaaaaaaaaaaaaaaaaaaaaaaaaaaaaaaaaaaaaaaaaaaaaaa
aaaaaaaaaaaaaaaaaaaaaaaaaaaaaaaaaaaaaaaaaaaaaaaaaaaaaaaaaaaaaaaaaaaaaaaaaaaaaaaaaaaaaaaaaaaaaaaaaaaa
"}
